#########################################
#S...#.............###.............#....#
#....#.............###.............#....#
#....#.............###.............#....#
#....#####.###########.#########.###.####
#........#.#.........#.#.......#.....I..#
#........#.#.........#.#.......#........#
#........#.#.........#.#.......#........#
####.#####.#.#######.#.#.#####.#########
#....#.....#.....I...#.#.....#.........#
#....#.....#.........#.#.....#.........#
#....#.....#.........#.#.....#.........#
#.####.#########.#####.#####.#####.#####
#......#.......#.......#.....#...#.....#
#......#.......#.......#.....#...#.....#
#......#.......#.......#.....#...#.....#
#####.###.###.###########.###.#.###.####
#I....#...#...#.........#...#.#.....E..#
#.....#...#...#.........#...#.#........#
#.....#...#...#.........#...#.#........#
#.#####.###.###.#######.###.#.#########
#.......#.......#.....#.....#.........#
#.......#.......#.....#.....#.........#
#.......#.......#.....#.....#.........#
#######.#######.#.###.#####.#####.#####
#.....#.......#.#...#.....#.....#.....#
#.....#.......#.#...#.....#.....#.....#
#.....#.......#.#...#.....#.....#.....#
#.###.###.#####.###.#####.###.###.#####
#...#.....#.........I.....#...#.......#
#...#.....#...............#...#.......#
#...#.....#...............#...#.......#
###.#####.###############.###.#####.###
#E..IIII#...............#.....#.....E.#
#...IIII#...............#.....#.......#
#.......#...............#.....#.......#
#########################################