#########################################
#S...#.I...........###I.......I....#....#
#....#....I......I.###...I.......I.#....#
#....#.......I.....###.....I.......#....#
#....#####.###########.#########.###.####
#........#.#.........#.#.....I.#.....I..#
#........#.#.....I...#.#.I.....#.I......#
#........#.#.I.......#.#.......#.I......#
####.#####.#.#######.#.#.#####.#######.#
#....#I....#.....I...#.#..I..#.....I...#
#....#.....#.........#.#.....#.I.......#
#...I#..I..#..I......#.#.I...#.......I.#
#.####.#########.#####.#####.#####.#####
#......#.....I.#.......#.....#...#.....#
#...I..#..I....#.I.....#.....#I..#..I..#
#......#.......#....I..#.....#...#I....#
#####.###.###.###########.###.#.###.####
#I....#..I#...#..I......#...#.#.....E..#
#.....#...#I..#......I..#...#.#........#
#.....#...#...#I...I....#...#.#........#
#.#####.###.###.#######.###.#.#########
#.....I.#.......#I....#.....#........I#
#.......#.......#.....#I....#.I.......#
#..I....#.I.....#.....#.....#I........#
#######.#######.#.###.#####.#####.#####
#.....#.......#.#..I#.....#..I..#....I#
#...I.#..I....#.#...#.....#.....#.....#
#I....#......I#.#...#.....#....I#....I#
#.###.###.#####.###.#####.###.###.#####
#...#.....#.........I.....#I..#.......#
#...#I....#...............#...#.......#
#...#.....#...I....I......#...#.......#
###.#####.###############.###.#####.###
#E......#...............#.....#.....E.#
#.......#...............#.....#.......#
#.......#I...........I..#....I#.......#
#########################################